的 : -ный (суффикс, чей)
一 : один
是 : есть, да!
不 : нет
了 : (знак прош. времени [результата])
人 : человек
!在 : в, быть
我 : я
!有 : *иметь
中 : *внутри
*这 : это
大 : большой
国 : страна
上 : верх
个 : (измер.слово)
来 : приехать
他 : он
*为 : для, стать
到 : прибыть
地 : земля, (суффикс наречий)
和 : с
时 : час
们 : (множ. число)
年 : год
生 : проживание [существо]
会 : встреча
出 : выходить
就 : сейчас
子 : сын
要 : хотеть
也 : и также
以 : с
说 : сказать
学 : учитесь
得 : доберитесь
对 : к
下 : основание
那 : это
可 : может
过 : сверх
于 : в
之 : это
后 : императрица
着 : получить
主 : владеть, хозяин
能 : может
里 : ли (китайская миля)
多 : многие
小 : маленький
而 : но
你 : Вы
天 : день
家 : дом
去 : пойти в
工 : работа
十 : десять
用 : использование [?]
作 : сделать
分 : цент
发 : волосы
自 : от
成 : завершать
都 : все
方 : квадрат (площадь)
民 : люди
好 : хороший
日 : день [и Солнце]
还 : возвратитесь
经 : через
没 : не делать
同 : вместе
如 : типа
她 : она
么 : (вопросит. час-ца)
起 : повышение
本 : это
行 : линия
心 : сердце
所 : фактически, место
然 : правильно
事 : вещь
现 : теперь
三 : три
加 : добавить
想 : думать
面 : сторона, поверхность
开 : открыть
电 : электричество
种 : расти
前 : фронт
当 : когда
美 : красивый
二 : два
外 : снаружи
道 : путь
从 : от
动 : движение(шаг)
看 : смотреть
业 : дело, занятие
高 : высоко
者 : (суффикс чел-ка, профессии)
法 : метод
但 : но
些 : количество
实 : тело
只 : только
老 : старый
长 : долго
月 : месяц
与 : с
两 : два
文 : текст [знак?]
部 : отдел
最 : больше всего
样 : вид
意 : идея
进 : вступить
很 : очень
机 : машина (механизм)
又 : снова [?]
力 : вмятина [?]
全 : все
点 : пункт(точка)
四 : четыре
头 : голова
已 : уже
因 : из-за
等 : и тд
问 : спросить
新 : новый
此 : это
定 : обоснуйтесь
正 : уверенный
知 : знать
情 : чувство
无 : не иметь
回 : возвратитесь
明 : ясный
手 : рука
产 : произвести
气 : дух
话 : слова
重 : тяжело
几 : несколько
表 : часы
由 : от
它 : это
将 : будет
化 : поворот
女 : женщина
五 : пять
代 : от имени
相 : взаимно
平 : даже [и ?]
或 : или
九 : девять
水 : вода
社 : агентство
比 : отношение
内 : внутри
军 : солдат
车 : автомобиль
使 : сделать
制 : сделать
度 : степень(градус)
向 : руководство(направление)
并 : и
活 : живой
关 : проход
总 : общее количество
给 : дать
入 : в [входить]
员 : член
身 : тело
见 : см
常 : часто
被 : двигатель
西 : запад
次 : время
期 : период
各 : каждый
及 : и
少 : немного
打 : бивший
特 : с
象 : слон
口 : [рот?]
应 : если
东 : восток
太 : также
报 : сообщение
海 : море
台 : набор
合 : состязание(спичка)
反 : анти-
万 : десять тысяч
利 : выгода
再 : снова
物 : вещь
真 : верный
别 : не делать
场 : область(поле)
山 : гора
声 : голос
信 : письмо
八 : восемь
命 : жизнь
提 : подъем(лифт)
市 : муниципальный
百 : 100.
件 : часть
性 : секс
数 : число(номер)
书 : книга
门 : дверь
更 : больше
路 : дорога
先 : сначала
每 : каждый
教 : преподавать
放 : помещенный
六 : шесть
计 : счет
至 : к
做 : сделать
原 : оригинал
世 : целая жизнь
展 : выставка
边 : сторона
任 : срок(термин)
解 : решение
干 : трахнитесь
才 : только
受 : пострадать
界 : граница
许 : позволить
处 : место
队 : бригада
义 : справедливость
系 : отдел
北 : север
请 : пожалуйста
安 : мирный
结 : узел
光 : свет
指 : пункт(точка)
今 : теперь
走 : прогулка
元 : доллар
量 : мера
便 : тогда
七 : семь
共 : полностью
接 : соединитесь
记 : отчет(рекорд)
金 : золото
难 : трудный
风 : бриз
色 : цвет
何 : почему
变 : изменение(замена)
区 : область
眼 : глаз
白 : белый
党 : сторона(партия)
望 : надежда
认 : признать
建 : настроенный(установленный)
交 : передать
带 : взять
战 : война
爱 : любовь
运 : нести
收 : принять
听 : услышать
张 : часть
治 : лечение(средство)
则 : тогда
花 : цветок
思 : думать
却 : как бы то ни было
改 : изменение(замена)
南 : юг
形 : форма
非 : нет
达 : досягаемость
保 : защитить
必 : обязательно
议 : аргумент(спор)
京 : город
程 : расстояние
求 : просить
办 : сделать
远 : далеко
强 : сильный
设 : установить
言 : речь
告 : сказать
往 : к
观 : представление(вид)
科 : секция
传 : распространение
师 : преподаватель
感 : чувство
马 : лошадь
该 : если
领 : доберитесь
吃 : поесть
写 : написать
导 : лидерство
即 : а именно
红 : красный
近 : рядом
住 : живой
千 : тысяча
广 : широкий
取 : взять
清 : чистый
且 : и
讲 : говорить
权 : власть(мощь)
儿 : сын [?]
节 : строфа
管 : труба
空 : пустой
叫 : звонить
让 : позволить
步 : шаг
满 : полный
组 : набор
友 : друг
神 : абсолютное существо
算 : вычислить
半 : половина
持 : держитесь
转 : поворот
越 : больше
王 : король
片 : пластина
级 : класс
商 : компания
林 : лес (древесина)
语 : язык
石 : [камень?]
连 : соединиться
争 : [кисть для письма?]
视 : смотреть
谈 : разговор
单 : единственный(отдельный)
深 : глубоко
钱 : деньги
周 : неделя
字 : слово
府 : особняк
式 : напечатать
司 : отдел
照 : сияние на
德 : добродетельный
据 : согласно
未 : нет
际 : по случаю
极 : полюс(поляк)
线 : линия
离 : отпуск
容 : пропуск
拿 : взять
史 : история
热 : горячий
团 : полк
早 : рано
快 : быстрый
包 : пакет
装 : пакет
调 : приспособьтесь
农 : сельское хозяйство
准 : позволить
类 : напечатать
约 : примерно (грубо)
号 : число (номер)
集 : соберитесь
克 : грамм
毛 : волосы
士 : [воин?]
夜 : ночь
布 : ткань
较 : чем
选 : выбрать
笑 : улыбка
造 : строить
整 : целое
晚 : ночь
切 : пластина
称 : звонить
格 : место(космос)
失 : проиграть
拉 : напряжение
死 : умереть
怎 : как
料 : ожидать
房 : здание
易 : легкий
曾 : однажды
始 : начало
需 : потребность
找 : искать
厂 : фабрика [?]
响 : кольцо
夫 : человек(мужчина)
参 : три [??]
黑 : черный
母 : мать
火 : огонь (пожар)
志 : амбиция
备 : иметь
育 : преподавать
局 : бюро
派 : стороны (партии)
示 : показывать
根 : корень
亚 : секунда
首 : голова
席 : место
价 : цена
图 : диаграмма
买 : купить
李 : Защита
落 : падение
究 : исследовать
随 : с
病 : болезнь
规 : правила
男 : мужчина
苦 : горький(ожесточенный)
费 : плата
另 : другой
足 : нога
查 : проверить
验 : проверить
像 : напомнить
批 : критиковать
低 : низко
城 : город
举 : повышение
球 : шар(мяч)
湾 : залив
须 : должен
除 : разделенный на
香 : китайская свеча
增 : увеличение
岁 : год
注 : отметить
客 : гость
食 : пища(еда)
供 : обеспечить
具 : иметь
江 : река
油 : нефть(масло)
群 : группа
断 : перерыв
存 : спасти(сэкономить)
底 : основание
飞 : муха
仅 : только
仍 : все еще
愿 : желание
般 : вид
虽 : хотя
送 : послать
古 : Вы
段 : доля
引 : лидерство
土 : почва
续 : непрерывно
版 : версия
案 : случай
令 : стопка
兵 : солдат
帮 : помощь
刚 : только
某 : некоторые
绝 : уникальный
医 : лечение(средство)
紧 : напряженный
划 : ряд
希 : редкий
春 : весна
显 : показ
游 : посещение
演 : игра(пьеса)
击 : выстрел(попытка)
居 : проживать
倒 : лейтесь
站 : стенд
例 : пример
喜 : рад
左 : оставленный
否 : отрицать
围 : вокруг
饭 : рис
列 : ряд
血 : кровь
推 : толчок
故 : так
父 : отец
坐 : сидеть
留 : пребывание
河 : река
念 : читать
船 : судно
久 : долго
属 : принадлежать
排 : ряд
致 : так что в итоге
初 : начало
跟 : следовать
职 : работа
双 : двойной
句 : предложение
朋 : компаньон
妈 : мама
村 : деревня
画 : живопись
够 : достаточно
助 : помощь
待 : удовольствие
乡 : страна
标 : марка
省 : область
采 : принять (goo: выбирать), собирать?
投 : швырнуть
右 : право
速 : скоро
器 : машина(механизм)
压 : нажать
值 : ценность
考 : тест(испытание)
读 : читать
谁 : кто
层 : слой
票 : билет
角 : Мыс
哪 : который
洋 : океан
创 : создать
章 : глава
云 : облако
印 : печать
停 : остановитесь
衣 : платье
树 : дерево
修 : установить
港 : гавань
质 : качество
脑 : мозг
刊 : издать
按 : нажать
尽 : опустошенный
破 : перерыв
诉 : сказать
害 : вред
枪 : оружие
卖 : продать
室 : комната(место)
波 : волна
米 : рис
甚 : очень
刻 : гравировать
微 : крошечный
冲 : вымойтесь
闻 : запах
班 : класс
怕 : опасение
超 : высшего качества
项 : пункт(изделие)
伤 : вред
背 : продолжить заднюю часть
呼 : крик
细 : тонкий
止 : [стоять?]
哥 : старший брат
型 : напечатать
答 : ответ
继 : после
依 : согласно
块 : часть
沉 : слив
终 : в конечном счете
富 : обогатить
竟 : неожиданно
获 : доберитесь
您 : Вы
若 : если
奇 : странный
占 : доля(акция)
负 : отрицательный
错 : ошибка
夏 : лето
差 : плохо
歌 : песня
痛 : болезненный
板 : доска
州 : государство (состояние)
皮 : кожа
源 : источник
汽 : пар
亮 : яркий
笔 : ручка
养 : держать
园 : парк
脸 : лицо
换 : изменение(замена)
景 : представление(вид)
烈 : сильный
副 : вице-
顾 : проявить внимание
阶 : разряд
唱 : петь
纸 : бумага(газета)
店 : склад(магазин)
编 : коса
跑 : управляемый
余 : сохранение
惊 : удивленный
激 : пробудитесь
田 : сельхозугодья [рисовое поле]
订 : заказ(порядок)
假 : ложный
雨 : дождь
木 : лес (древесина)
益 : выгода
靠 : зависеть
限 : предел
判 : судья
试 : пробовать
防 : защитить
急 : противный
诗 : поэма
味 : аромат
货 : товары
升 : повышение
射 : охота(выстрел)
叶 : лист
沙 : песок
冷 : холод
短 : короткий
配 : пойти вместе с
搞 : сделать
款 : стиль
草 : трава
银 : серебро
酒 : вино
旧 : старый
曲 : песня
素 : овощ
朝 : династия
环 : венок
陆 : шесть
积 : накопитесь
街 : улица
铁 : железо
免 : не нуждайтесь
庭 : суд
楼 : пол(этаж)
洲 : континент
脚 : ноги
卡 : карта
预 : подготовитесь
善 : хорошо
均 : все
封 : печать
剧 : игра(пьеса)
堂 : зал
渐 : постепенно
雪 : снег
承 : принять
模 : почва
状 : форма
乱 : беспорядочно
担 : груз
课 : урок
减 : уменьшить(сократить)
忘 : забыть
弟 : младший брат
杀 : убить
药 : медицина(лекарство)
怀 : грудь
互 : друг с другом
既 : с тех пор
旅 : поездка
钟 : часы
弹 : игра(пьеса)
姐 : старшая сестра
贵 : дорогой
罪 : нарушение
宝 : сокровище
置 : место
翻 : перевернуть
毕 : конец
谢 : спасибо
述 : сказать
登 : поднимитесь
材 : материал
穿 : изнашивание
寄 : послать
玩 : игра(пьеса)
略 : немного
菜 : овощи
烟 : дым
礼 : подарок
龙 : дракон
户 : дверь
抗 : анти-
攻 : оскорбить
犯 : сделать
访 : посещение
困 : западня
牌 : карта
追 : сделать след(курс) для
松 : свободный
睡 : сон
掉 : снижение(капля)
午 : полдень
移 : движение(шаг)
招 : новичок(новобранец)
降 : снижение
慢 : медленный
宁 : скорее
良 : хороший
肉 : мясо
遍 : время
率 : норма(разряд)
练 : практика
丰 : обильный(просторный)
付 : плата
挥 : щелчок
控 : контроль(управление)
敢 : сметь
灯 : свет
舞 : танец
忙 : занятый(занятой)
私 : частный
顺 : приятный
坏 : плохо
县 : графство
牛 : корова
肯 : желание к
遇 : встретьтесь
输 : проиграть
馆 : здание
签 : признак(подпись)
退 : назад
熟 : знакомый
缺 : нехватка
爸 : папа
绿 : зеленый
盘 : блюдо
鱼 : рыба
哭 : крик
湖 : озеро
套 : набор
戏 : драма
救 : спасти(сэкономить)
屋 : дом
灵 : работа должным образом
顶 : гребень
浪 : волна
零 : ноль
亿 : сто миллионов
怪 : странный
透 : глубоко
恶 : плохо
拍 : хлопнуть
误 : ошибка
额 : сумма
载 : нести
征 : поместить объявление
脱 : взлететь
托 : дать
弄 : переулок
摇 : толчок
抓 : схватывание
轮 : вокруг
篇 : статья(изделие)
秋 : осень
厚 : толстый
季 : четверть(квартал)
雄 : мужчина
恐 : опасение
税 : налоговый закон
窗 : окно
弱 : слабый
赛 : состязание(спичка)
归 : возвратитесь
倍 : времена
播 : свинья
借 : заимствовать
末 : конец
玉 : нефрит [яшма]
旁 : около
跳 : скачок
休 : отдыхать
唯 : но
端 : нести
迫 : сила
